//MAP CONVERTED BY dmm2tgm.py THIS HEADER COMMENT PREVENTS RECONVERSION, DO NOT REMOVE
"a" = (
/turf/simulated/floor/plating/planet/jungle/templatethick,
/area/jungle)
"b" = (
/turf/simulated/floor/plating/planet/jungle/rock,
/area/jungle)
"c" = (
/turf/simulated/floor/plating/planet/jungle/clear/underground,
/area/jungle)
"d" = (
/obj/effect/spider,
/turf/simulated/floor/plating/planet/jungle/clear/underground,
/area/jungle)
"e" = (
/obj/effect/decal/cleanable/dirt,
/turf/simulated/floor/plating/planet/jungle/clear/underground,
/area/jungle)
"f" = (
/obj/random/loot,
/obj/structure/closet/crate,
/obj/random/maintenance/clean,
/obj/random/maintenance/clean,
/turf/simulated/floor/plating/planet/jungle/clear/underground,
/area/jungle)
"g" = (
/obj/effect/spider,
/obj/effect/decal/cleanable/cobweb,
/obj/effect/decal/cleanable/dirt,
/turf/simulated/floor/plating/planet/jungle/clear/underground,
/area/jungle)

(1,1,1) = {"
a
a
a
a
a
a
a
a
a
a
a
a
a
"}
(2,1,1) = {"
a
a
a
a
a
b
b
b
b
b
a
a
a
"}
(3,1,1) = {"
a
a
a
b
b
b
c
c
c
b
b
a
a
"}
(4,1,1) = {"
a
a
b
b
b
d
c
b
e
e
b
b
a
"}
(5,1,1) = {"
a
a
b
b
c
c
c
b
b
e
b
b
a
"}
(6,1,1) = {"
a
b
b
b
c
c
c
c
b
e
e
g
a
"}
(7,1,1) = {"
a
b
b
c
c
c
c
b
b
b
b
b
a
"}
(8,1,1) = {"
b
b
c
c
c
c
b
b
b
b
b
b
a
"}
(9,1,1) = {"
b
b
c
c
c
b
b
b
c
b
b
b
a
"}
(10,1,1) = {"
b
b
c
c
c
c
b
c
c
f
b
b
a
"}
(11,1,1) = {"
b
b
c
c
c
c
c
c
c
c
b
b
a
"}
(12,1,1) = {"
a
b
b
c
c
c
c
c
c
b
b
a
a
"}
(13,1,1) = {"
a
a
b
b
c
c
c
c
b
b
a
a
a
"}
(14,1,1) = {"
a
a
b
b
b
b
b
b
b
a
a
a
a
"}
(15,1,1) = {"
a
a
a
b
b
b
b
b
a
a
a
a
a
"}
