//MAP CONVERTED BY dmm2tgm.py THIS HEADER COMMENT PREVENTS RECONVERSION, DO NOT REMOVE
"aa" = (
/turf/space,
/area/space)
"ab" = (
/obj/structure/catwalk,
/turf/space,
/area/space)
"ac" = (
/turf/simulated/wall,
/area/medical/surgery)
"ad" = (
/obj/effect/floor_decal/corner/blue/diagonal,
/obj/structure/iv_drip,
/obj/item/weapon/reagent_containers/ivbag/blood/OMinus,
/obj/item/weapon/reagent_containers/ivbag/blood/OMinus,
/obj/item/weapon/reagent_containers/ivbag/blood/OMinus,
/turf/simulated/floor/tiled/white,
/area/medical/surgery)
"ae" = (
/obj/effect/floor_decal/corner/blue/diagonal,
/obj/machinery/optable,
/turf/simulated/floor/tiled/white,
/area/medical/surgery)
"af" = (
/obj/effect/floor_decal/corner/blue/diagonal,
/obj/machinery/computer/operating,
/turf/simulated/floor/tiled/white,
/area/medical/surgery)
"ag" = (
/obj/machinery/light{
	dir = 1
	},
/obj/effect/floor_decal/corner/blue/diagonal,
/obj/structure/table/glass,
/obj/item/weapon/storage/box/syringes,
/obj/item/weapon/storage/box/freezer,
/turf/simulated/floor/tiled/white,
/area/medical/surgery)
"ah" = (
/obj/effect/floor_decal/corner/blue/diagonal,
/obj/structure/table/glass,
/obj/item/weapon/storage/box/gloves,
/obj/item/weapon/storage/box/masks,
/turf/simulated/floor/tiled/white,
/area/medical/surgery)
"ai" = (
/obj/effect/floor_decal/corner/blue/diagonal,
/turf/simulated/floor/tiled/white,
/area/medical/surgery)
"aj" = (
/obj/structure/lattice,
/turf/simulated/open,
/area/medical/surgery)
"ak" = (
/obj/machinery/light{
	dir = 1
	},
/obj/effect/floor_decal/corner/blue/diagonal,
/turf/simulated/floor/tiled/white,
/area/medical/surgery)
"al" = (
/obj/effect/floor_decal/corner/blue/diagonal,
/obj/structure/table/glass,
/obj/item/weapon/storage/firstaid/surgery,
/turf/simulated/floor/tiled/white,
/area/medical/surgery)
"am" = (
/obj/effect/floor_decal/corner/blue/diagonal,
/obj/structure/hygiene/sink{
	dir = 4;
	icon_state = "sink"
	},
/turf/simulated/floor/tiled/white,
/area/medical/surgery)
"an" = (
/turf/simulated/open,
/area/medical/surgery)
"ao" = (
/obj/effect/floor_decal/corner/blue/diagonal,
/obj/structure/table/glass,
/obj/item/weapon/reagent_containers/dropper,
/obj/item/weapon/reagent_containers/chem_disp_cartridge/peridaxon,
/obj/item/stack/nanopaste,
/obj/machinery/light{
	dir = 8;
	icon_state = "tube1"
	},
/turf/simulated/floor/tiled/white,
/area/medical/surgery)
"ap" = (
/obj/effect/floor_decal/corner/blue/diagonal,
/obj/machinery/body_scanconsole{
	dir = 4;
	icon_state = "body_scannerconsole"
	},
/turf/simulated/floor/tiled/white,
/area/medical/surgery)
"aq" = (
/obj/effect/floor_decal/corner/blue/diagonal,
/obj/machinery/bodyscanner{
	dir = 4;
	icon_state = "body_scanner_0"
	},
/turf/simulated/floor/tiled/white,
/area/medical/surgery)
"ar" = (
/obj/effect/floor_decal/corner/blue/diagonal,
/obj/machinery/sleeper{
	dir = 8;
	icon_state = "sleeper_0"
	},
/turf/simulated/floor/tiled/white,
/area/medical/surgery)
"as" = (
/obj/machinery/light_switch{
	pixel_x = 25
	},
/obj/effect/floor_decal/corner/blue/diagonal,
/turf/simulated/floor/tiled/white,
/area/medical/surgery)
"at" = (
/obj/effect/floor_decal/corner/blue/diagonal,
/obj/structure/table/glass,
/obj/item/weapon/scalpel/laser1,
/obj/item/weapon/scalpel/laser2,
/obj/item/weapon/scalpel/laser3,
/obj/item/device/robotanalyzer,
/obj/item/device/healthanalyzer,
/obj/item/weapon/storage/firstaid/adv,
/turf/simulated/floor/tiled/white,
/area/medical/surgery)
"au" = (
/obj/effect/floor_decal/corner/blue/diagonal,
/obj/structure/ladder/updown,
/turf/simulated/floor/tiled/white,
/area/medical/surgery)
"av" = (
/obj/effect/floor_decal/corner/blue/diagonal,
/obj/machinery/atmospherics/unary/freezer,
/turf/simulated/floor/tiled/white,
/area/medical/surgery)
"aw" = (
/obj/effect/floor_decal/corner/blue/diagonal,
/obj/machinery/atmospherics/unary/cryo_cell,
/turf/simulated/floor/tiled/white,
/area/medical/surgery)
"ax" = (
/obj/effect/floor_decal/corner/blue/diagonal,
/obj/machinery/portable_atmospherics/canister/oxygen/prechilled,
/obj/machinery/atmospherics/portables_connector,
/turf/simulated/floor/tiled/white,
/area/medical/surgery)
"ay" = (
/obj/effect/floor_decal/corner/blue/diagonal,
/obj/machinery/light{
	dir = 4;
	icon_state = "tube1"
	},
/turf/simulated/floor/tiled/white,
/area/medical/surgery)
"az" = (
/obj/effect/floor_decal/corner/blue/diagonal,
/obj/structure/closet/secure_closet/freezer/meat,
/turf/simulated/floor/tiled/white,
/area/medical/surgery)
"aA" = (
/obj/effect/floor_decal/corner/blue/diagonal,
/obj/machinery/mecha_part_fabricator,
/turf/simulated/floor/tiled/white,
/area/medical/surgery)
"aB" = (
/obj/effect/floor_decal/corner/blue/diagonal,
/obj/machinery/atmospherics/pipe/simple/visible/blue{
	dir = 5;
	icon_state = "intact"
	},
/turf/simulated/floor/tiled/white,
/area/medical/surgery)
"aC" = (
/obj/effect/floor_decal/corner/blue/diagonal,
/obj/machinery/atmospherics/pipe/manifold/visible/blue,
/obj/item/weapon/reagent_containers/glass/beaker/cryoxadone,
/turf/simulated/floor/tiled/white,
/area/medical/surgery)
"aD" = (
/obj/effect/floor_decal/corner/blue/diagonal,
/obj/machinery/atmospherics/pipe/simple/visible/blue{
	dir = 9;
	icon_state = "intact"
	},
/turf/simulated/floor/tiled/white,
/area/medical/surgery)
"aE" = (
/obj/machinery/atmospherics/unary/vent_pump/on,
/obj/effect/floor_decal/corner/blue/diagonal,
/turf/simulated/floor/tiled/white,
/area/medical/surgery)
"aF" = (
/obj/effect/floor_decal/corner/blue/diagonal,
/obj/machinery/organ_printer/flesh/mapped,
/turf/simulated/floor/tiled/white,
/area/medical/surgery)
"aG" = (
/obj/machinery/atmospherics/pipe/simple/visible{
	dir = 5;
	icon_state = "intact"
	},
/obj/effect/floor_decal/corner/blue/diagonal,
/turf/simulated/floor/tiled/white,
/area/medical/surgery)
"aH" = (
/obj/machinery/atmospherics/pipe/simple/visible{
	dir = 4;
	icon_state = "intact"
	},
/obj/effect/floor_decal/corner/blue/diagonal,
/turf/simulated/floor/tiled/white,
/area/medical/surgery)
"aI" = (
/obj/machinery/atmospherics/portables_connector{
	dir = 8;
	icon_state = "map_connector"
	},
/obj/machinery/portable_atmospherics/canister/air,
/obj/effect/floor_decal/corner/blue/diagonal,
/turf/simulated/floor/tiled/white,
/area/medical/surgery)
"aJ" = (
/obj/effect/floor_decal/corner/blue/diagonal,
/obj/machinery/organ_printer/robot/mapped,
/turf/simulated/floor/tiled/white,
/area/medical/surgery)
"aK" = (
/obj/effect/floor_decal/corner/blue/diagonal,
/obj/structure/table/rack,
/obj/item/stack/material/plasteel/fifty,
/obj/item/stack/material/steel/fifty,
/obj/item/stack/material/glass/fifty,
/obj/item/stack/material/gold/ten,
/obj/item/stack/material/mhydrogen/ten,
/obj/item/stack/material/silver/ten,
/obj/item/stack/material/uranium/ten,
/obj/item/stack/material/diamond/ten,
/obj/item/stack/material/phoron/fifty,
/obj/item/weapon/storage/belt/utility/full,
/obj/item/stack/material/steel/fifty,
/turf/simulated/floor/tiled/white,
/area/medical/surgery)
"aL" = (
/obj/machinery/atmospherics/pipe/simple/visible{
	dir = 6;
	icon_state = "intact"
	},
/obj/effect/floor_decal/corner/blue/diagonal,
/turf/simulated/floor/tiled/white,
/area/medical/surgery)
"aM" = (
/obj/machinery/atmospherics/portables_connector{
	dir = 8;
	icon_state = "map_connector"
	},
/obj/machinery/portable_atmospherics/canister/empty,
/obj/effect/floor_decal/corner/blue/diagonal,
/turf/simulated/floor/tiled/white,
/area/medical/surgery)
"aN" = (
/obj/machinery/light_switch{
	pixel_x = -25
	},
/obj/effect/floor_decal/corner/blue/diagonal,
/turf/simulated/floor/tiled/white,
/area/medical/surgery)
"aO" = (
/obj/machinery/atmospherics/unary/vent_scrubber/on{
	dir = 1;
	icon_state = "map_scrubber_on"
	},
/obj/effect/floor_decal/corner/blue/diagonal,
/turf/simulated/floor/tiled/white,
/area/medical/surgery)
"aP" = (
/obj/machinery/light{
	dir = 8;
	icon_state = "tube1"
	},
/obj/effect/floor_decal/corner/blue/diagonal,
/turf/simulated/floor/tiled/white,
/area/medical/surgery)
"aQ" = (
/obj/machinery/light{
	dir = 4;
	icon_state = "tube1"
	},
/obj/effect/floor_decal/corner/blue/diagonal,
/turf/simulated/floor/tiled/white,
/area/medical/surgery)
"aR" = (
/obj/structure/cable{
	d2 = 2;
	icon_state = "0-2";
	pixel_y = 0
	},
/obj/machinery/power/apc{
	dir = 8;
	name = "west bump";
	pixel_x = -24
	},
/obj/effect/floor_decal/corner/blue/diagonal,
/turf/simulated/floor/tiled/white,
/area/medical/surgery)
"aS" = (
/obj/structure/cable{
	d1 = 1;
	d2 = 2;
	icon_state = "1-2";
	pixel_y = 0
	},
/obj/effect/floor_decal/corner/blue/diagonal,
/turf/simulated/floor/tiled/white,
/area/medical/surgery)
"aT" = (
/obj/structure/cable,
/obj/machinery/power/debug_items/infinite_generator,
/obj/effect/floor_decal/corner/blue/diagonal,
/turf/simulated/floor/tiled/white,
/area/medical/surgery)
"aU" = (
/obj/machinery/light,
/obj/effect/floor_decal/corner/blue/diagonal,
/turf/simulated/floor/tiled/white,
/area/medical/surgery)
"aV" = (
/obj/structure/lattice,
/obj/structure/ladder/updown,
/turf/space,
/area/space)
"aX" = (
/obj/structure/lattice,
/turf/space,
/area/space)
"aY" = (
/obj/effect/wingrille_spawn/reinforced,
/turf/simulated/floor/plating,
/area/medical/surgery)
"aZ" = (
/obj/structure/catwalk,
/obj/structure/lattice,
/turf/simulated/open,
/area/medical/surgery)
"uS" = (
/obj/effect/floor_decal/corner/blue/diagonal,
/obj/machinery/ntnet_relay,
/turf/simulated/floor/tiled/white,
/area/medical/surgery)
"Ij" = (
/turf/simulated/floor/plating/airless,
/area/space)
"Pr" = (
/obj/structure/lattice,
/turf/simulated/floor/plating/airless,
/area/space)

(1,1,1) = {"
aa
aa
aa
aa
aa
aa
aa
aa
aa
aa
aa
aa
aa
aa
aa
aa
aa
aa
aa
aa
aa
aa
aa
aa
aa
aa
aa
aa
aa
aa
aa
aa
"}
(2,1,1) = {"
aa
aa
aa
aa
aa
aa
aa
aa
aa
aa
aa
aa
aa
aa
aa
aa
aa
aa
aa
aa
aa
aa
aa
aa
aa
aa
aa
aa
aa
aa
aa
aa
"}
(3,1,1) = {"
aa
aa
aa
aa
aa
aa
aa
aa
aa
aa
aa
aa
aa
aa
aa
aa
aa
aa
aa
aa
aa
aa
aa
aa
aa
aa
aa
aa
aa
aa
aa
aa
"}
(4,1,1) = {"
aa
aa
aa
aa
aa
aa
aa
aa
aa
aa
aa
aa
aa
aa
aa
aa
aa
aa
aa
aa
aa
aa
aa
aa
aa
aa
aa
aa
aa
aa
aa
aa
"}
(5,1,1) = {"
aa
aa
aa
aa
aa
aa
aa
aa
aa
aa
aa
aa
aa
aa
aa
aa
aa
aa
aa
aa
aa
aa
aa
aa
aa
aa
aa
aa
aa
aa
aa
aa
"}
(6,1,1) = {"
aa
aa
aa
aa
aa
aa
aa
aa
aa
aa
aa
aa
aa
aa
aa
aa
aa
aa
aa
aa
aa
aa
aa
aa
aa
aa
aa
aa
aa
aa
aa
aa
"}
(7,1,1) = {"
aa
aa
aa
aa
aa
aa
aa
aa
aa
aa
aa
aa
aa
aa
aa
aa
aa
aa
aa
aa
aa
aa
aa
aa
aa
aa
aa
aa
aa
aa
aa
aa
"}
(8,1,1) = {"
aa
aa
aa
aa
aa
aa
aa
aa
aa
aa
aa
aa
aa
aa
aa
aa
aa
aa
aa
aa
aa
aa
aa
aa
aa
aa
aa
aa
aa
aa
aa
aa
"}
(9,1,1) = {"
aa
aa
aa
aa
aa
aa
aa
aa
aa
aa
aa
aa
aa
aa
aa
aa
aa
aa
aa
aa
aa
aa
aa
aa
aa
aa
aa
aa
aa
aa
aa
aa
"}
(10,1,1) = {"
aa
aa
aa
aa
aa
aa
aa
aa
aa
aa
aa
aa
aa
aa
aa
aa
aa
aa
aa
aa
aa
aa
aa
aa
aa
aa
aa
aa
aa
aa
aa
aa
"}
(11,1,1) = {"
aa
aa
aa
aa
aa
aa
aa
aa
aa
aa
aa
aa
aa
aa
aa
aa
aa
aa
aa
aa
aa
aa
aa
aa
aa
aa
aa
aa
aa
aa
aa
aa
"}
(12,1,1) = {"
aa
aa
aa
aa
aa
aa
aa
aa
aa
aa
aa
aa
aa
aa
aa
aa
aa
aa
aa
aa
aa
aa
aa
aa
aa
aa
aa
aa
aa
aa
aa
aa
"}
(13,1,1) = {"
aa
aa
aa
aa
aa
aa
aa
aa
aa
aa
aa
aa
aa
aa
aa
aa
aa
aa
aa
aa
aa
aa
aa
aa
aa
aa
aa
aa
aa
aa
aa
aa
"}
(14,1,1) = {"
aa
aa
aa
aa
aa
aa
aa
aa
aa
aa
aa
aa
aa
aa
aa
aa
aa
aa
aa
aa
aa
aa
aa
aa
aa
aa
aa
aa
aa
aa
aa
aa
"}
(15,1,1) = {"
aa
aa
aa
aa
aa
aa
aa
aa
aa
aa
aa
aX
aa
aa
ab
ab
ab
ab
ab
aa
aa
aX
aa
aa
aa
aa
aa
aa
aa
aa
aa
aa
"}
(16,1,1) = {"
aa
aa
aa
aa
aa
aa
aa
aX
aX
aX
aX
aX
aX
aX
aV
aX
aX
Pr
Pr
Pr
aX
aX
aX
aX
aX
aX
aa
aa
aa
aa
aa
aa
"}
(17,1,1) = {"
aa
aa
aa
aa
aa
aa
aa
aX
aa
aa
aa
aX
aa
aa
aX
aa
aX
Ij
Pr
Ij
aa
aX
aa
aa
aa
aX
aa
aa
aa
aa
aa
aa
"}
(18,1,1) = {"
aa
aa
aa
aa
aa
aa
aa
aX
aa
ac
ac
ac
ac
ac
ac
aY
aY
aY
ac
ac
ac
ac
ac
ac
aa
aX
aa
aa
aa
aa
aa
aa
"}
(19,1,1) = {"
aa
aa
aa
aa
aa
aa
aa
aX
aa
ac
ad
al
ao
at
az
aF
aJ
ai
aN
aP
aR
aS
aT
ac
aa
aX
aa
aa
aa
aa
aa
aa
"}
(20,1,1) = {"
aa
aa
aa
aa
aa
aa
aa
aX
aa
aY
ae
ai
ap
ai
ai
ai
ai
ai
ai
ai
ai
ai
ai
ac
aa
aX
aa
aa
aa
aa
aa
aa
"}
(21,1,1) = {"
aa
aa
aa
aa
aa
aa
aa
aX
aa
aY
af
ai
aq
ai
aA
ai
aK
ai
ai
ai
ai
ai
uS
ac
aa
aX
aa
aa
aa
aa
aa
aa
"}
(22,1,1) = {"
aa
aa
aa
aa
aa
aa
aa
aX
aX
ac
ag
ai
ai
ai
ai
ai
ai
ai
ai
ai
ai
ai
aU
ac
aX
aX
aa
aa
aa
aa
aa
aa
"}
(23,1,1) = {"
aa
aa
aa
aa
aa
aa
aa
aX
aa
aY
ah
am
ar
au
ai
ai
ai
ai
ai
ai
ai
ai
ai
ac
aa
aX
aa
aa
aa
aa
aa
aa
"}
(24,1,1) = {"
aa
aa
aa
aa
aa
aa
aa
aX
aa
aY
ai
aj
an
av
aB
ai
ai
an
an
aj
an
ai
ai
aY
aa
aX
aa
aa
aa
aa
aa
aa
"}
(25,1,1) = {"
aa
aa
aa
aa
aa
aa
aa
aX
aX
ac
aj
aj
an
aw
aC
ai
ai
aZ
aZ
aZ
aZ
ai
ai
aY
aa
aX
aa
aa
aa
aa
aa
aa
"}
(26,1,1) = {"
aa
aa
aa
aa
aa
aa
aa
aX
aa
aY
ai
an
an
ax
aD
ai
ai
an
aj
an
an
ai
ai
aY
aa
aX
aa
aa
aa
aa
aa
aa
"}
(27,1,1) = {"
aa
aa
aa
aa
aa
aa
aa
aX
aa
aY
ai
ai
ai
ai
ai
ai
ai
ai
ai
ai
ai
ai
ai
ac
aa
aX
aa
aa
aa
aa
aa
aa
"}
(28,1,1) = {"
aa
aa
aa
aa
aa
aa
aa
aX
aX
ac
ak
ai
ai
ai
ai
ai
ai
ai
ai
ai
ai
ai
aU
ac
aX
aX
aa
aa
aa
aa
aa
aa
"}
(29,1,1) = {"
aa
aa
aa
aa
aa
aa
aa
aX
aa
aY
ai
ai
ai
ai
aE
aG
ai
aL
aO
ai
ai
ai
ai
ac
aa
aX
aa
aa
aa
aa
aa
aa
"}
(30,1,1) = {"
aa
aa
aa
aa
aa
aa
aa
aX
aa
aY
ai
ai
ai
ai
ai
aH
ai
aH
ai
ai
ai
ai
ai
ac
aa
aX
aa
aa
aa
aa
aa
aa
"}
(31,1,1) = {"
aa
aa
aa
aa
aa
aa
aa
aX
aa
ac
ai
ai
as
ay
ai
aI
ai
aM
ai
aQ
ai
ai
ai
ac
aa
aX
aa
aa
aa
aa
aa
aa
"}
(32,1,1) = {"
aa
aa
aa
aa
aa
aa
aa
aX
aa
ac
ac
ac
ac
ac
ac
aY
aY
aY
ac
ac
ac
ac
ac
ac
aa
aX
aa
aa
aa
aa
aa
aa
"}
(33,1,1) = {"
aa
aa
aa
aa
aa
aa
aa
aX
aa
aa
aa
aa
aa
aa
aX
aa
aX
aa
aX
aa
aa
aa
aa
aa
aa
aX
aa
aa
aa
aa
aa
aa
"}
(34,1,1) = {"
aa
aa
aa
aa
aa
aa
aa
aX
aX
aX
aX
aX
aX
aX
aX
aX
aX
aX
aX
aX
aX
aX
aX
aX
aX
aX
aa
aa
aa
aa
aa
aa
"}
(35,1,1) = {"
aa
aa
aa
aa
aa
aa
aa
aa
aa
aa
aa
aa
aa
aa
aa
aa
aa
aa
aa
aa
aa
aa
aa
aa
aa
aa
aa
aa
aa
aa
aa
aa
"}
(36,1,1) = {"
aa
aa
aa
aa
aa
aa
aa
aa
aa
aa
aa
aa
aa
aa
aa
aa
aa
aa
aa
aa
aa
aa
aa
aa
aa
aa
aa
aa
aa
aa
aa
aa
"}
(37,1,1) = {"
aa
aa
aa
aa
aa
aa
aa
aa
aa
aa
aa
aa
aa
aa
aa
aa
aa
aa
aa
aa
aa
aa
aa
aa
aa
aa
aa
aa
aa
aa
aa
aa
"}
(38,1,1) = {"
aa
aa
aa
aa
aa
aa
aa
aa
aa
aa
aa
aa
aa
aa
aa
aa
aa
aa
aa
aa
aa
aa
aa
aa
aa
aa
aa
aa
aa
aa
aa
aa
"}
(39,1,1) = {"
aa
aa
aa
aa
aa
aa
aa
aa
aa
aa
aa
aa
aa
aa
aa
aa
aa
aa
aa
aa
aa
aa
aa
aa
aa
aa
aa
aa
aa
aa
aa
aa
"}
(40,1,1) = {"
aa
aa
aa
aa
aa
aa
aa
aa
aa
aa
aa
aa
aa
aa
aa
aa
aa
aa
aa
aa
aa
aa
aa
aa
aa
aa
aa
aa
aa
aa
aa
aa
"}
(41,1,1) = {"
aa
aa
aa
aa
aa
aa
aa
aa
aa
aa
aa
aa
aa
aa
aa
aa
aa
aa
aa
aa
aa
aa
aa
aa
aa
aa
aa
aa
aa
aa
aa
aa
"}
(42,1,1) = {"
aa
aa
aa
aa
aa
aa
aa
aa
aa
aa
aa
aa
aa
aa
aa
aa
aa
aa
aa
aa
aa
aa
aa
aa
aa
aa
aa
aa
aa
aa
aa
aa
"}
(43,1,1) = {"
aa
aa
aa
aa
aa
aa
aa
aa
aa
aa
aa
aa
aa
aa
aa
aa
aa
aa
aa
aa
aa
aa
aa
aa
aa
aa
aa
aa
aa
aa
aa
aa
"}
(44,1,1) = {"
aa
aa
aa
aa
aa
aa
aa
aa
aa
aa
aa
aa
aa
aa
aa
aa
aa
aa
aa
aa
aa
aa
aa
aa
aa
aa
aa
aa
aa
aa
aa
aa
"}
(45,1,1) = {"
aa
aa
aa
aa
aa
aa
aa
aa
aa
aa
aa
aa
aa
aa
aa
aa
aa
aa
aa
aa
aa
aa
aa
aa
aa
aa
aa
aa
aa
aa
aa
aa
"}
(46,1,1) = {"
aa
aa
aa
aa
aa
aa
aa
aa
aa
aa
aa
aa
aa
aa
aa
aa
aa
aa
aa
aa
aa
aa
aa
aa
aa
aa
aa
aa
aa
aa
aa
aa
"}
(47,1,1) = {"
aa
aa
aa
aa
aa
aa
aa
aa
aa
aa
aa
aa
aa
aa
aa
aa
aa
aa
aa
aa
aa
aa
aa
aa
aa
aa
aa
aa
aa
aa
aa
aa
"}
(48,1,1) = {"
aa
aa
aa
aa
aa
aa
aa
aa
aa
aa
aa
aa
aa
aa
aa
aa
aa
aa
aa
aa
aa
aa
aa
aa
aa
aa
aa
aa
aa
aa
aa
aa
"}
