//MAP CONVERTED BY dmm2tgm.py THIS HEADER COMMENT PREVENTS RECONVERSION, DO NOT REMOVE
"a" = (
/turf/simulated/floor/plating,
/area/maintenance/fsmaint)
"b" = (
/turf/simulated/wall,
/area/maintenance/fsmaint)
"c" = (
/turf/space,
/area/space)
"d" = (
/turf/space,
/area/shuttle/assault/a1/station)
"e" = (
/turf/simulated/wall,
/area/hallway/secondary/exit)
"f" = (
/obj/structure/grille,
/obj/structure/window/reinforced,
/obj/structure/window/reinforced{
	dir = 8
	},
/obj/structure/window/reinforced{
	dir = 1
	},
/turf/simulated/floor/plating,
/area/hallway/secondary/exit)
"g" = (
/obj/structure/grille,
/obj/structure/window/reinforced,
/obj/structure/window/reinforced{
	dir = 1
	},
/turf/simulated/floor/plating,
/area/hallway/secondary/exit)
"h" = (
/obj/structure/grille,
/obj/structure/window/reinforced,
/obj/structure/window/reinforced{
	dir = 1
	},
/obj/structure/window/reinforced{
	dir = 4
	},
/turf/simulated/floor/plating,
/area/hallway/secondary/exit)
"i" = (
/obj/machinery/door/firedoor,
/obj/machinery/door/airlock/hatch{
	name = "Observatory"
	},
/turf/simulated/floor/tiled,
/area/hallway/secondary/exit)
"j" = (
/turf/simulated/floor/tiled,
/area/hallway/secondary/exit)
"k" = (
/obj/machinery/light{
	dir = 1
	},
/turf/simulated/floor/tiled,
/area/hallway/secondary/exit)
"l" = (
/obj/machinery/light,
/turf/simulated/floor/tiled,
/area/hallway/secondary/exit)
"m" = (
/obj/machinery/light{
	dir = 4;
	icon_state = "tube1"
	},
/turf/simulated/floor/tiled,
/area/hallway/secondary/exit)
"n" = (
/turf/simulated/wall,
/area/template_noop)
"o" = (
/obj/machinery/light{
	dir = 8;
	icon_state = "tube1"
	},
/turf/simulated/floor/tiled,
/area/hallway/secondary/exit)
"p" = (
/obj/structure/grille,
/obj/structure/window/reinforced{
	dir = 4
	},
/obj/structure/window/reinforced{
	dir = 8
	},
/obj/structure/window/reinforced{
	dir = 1
	},
/turf/simulated/floor/plating,
/area/hallway/secondary/exit)
"q" = (
/obj/structure/grille,
/obj/structure/window/reinforced{
	dir = 4
	},
/obj/structure/window/reinforced{
	dir = 8
	},
/obj/structure/window/reinforced,
/turf/simulated/wall,
/area/hallway/secondary/exit)
"r" = (
/obj/machinery/door/airlock/external,
/turf/simulated/floor/tiled,
/area/hallway/secondary/exit)
"s" = (
/obj/structure/grille,
/obj/structure/window/reinforced{
	dir = 4
	},
/obj/structure/window/reinforced{
	dir = 8
	},
/turf/simulated/wall,
/area/hallway/secondary/exit)

(1,1,1) = {"
a
a
a
a
a
a
e
e
e
i
i
e
e
e
n
n
n
n
n
n
n
n
"}
(2,1,1) = {"
b
b
b
b
b
b
e
c
e
j
j
e
c
c
c
c
c
c
c
c
c
c
"}
(3,1,1) = {"
b
c
c
c
c
c
c
c
e
k
j
e
c
c
c
c
c
c
c
c
c
c
"}
(4,1,1) = {"
c
c
c
c
c
c
c
c
f
j
j
e
c
c
c
c
c
c
c
c
c
c
"}
(5,1,1) = {"
c
c
c
c
c
c
c
c
g
j
j
e
c
c
c
c
c
c
c
c
c
c
"}
(6,1,1) = {"
c
c
c
c
c
c
c
c
g
j
j
e
c
c
c
c
c
c
c
c
c
c
"}
(7,1,1) = {"
c
c
c
c
c
c
c
c
g
j
l
e
e
e
e
p
q
e
e
e
e
e
"}
(8,1,1) = {"
c
c
c
c
c
c
c
c
h
j
j
j
j
j
o
j
j
j
j
j
l
e
"}
(9,1,1) = {"
c
c
c
c
c
c
c
c
e
j
j
j
m
j
j
j
j
j
j
j
j
f
"}
(10,1,1) = {"
c
c
c
c
c
c
c
c
e
e
e
e
e
e
e
p
q
e
e
j
j
g
"}
(11,1,1) = {"
d
d
d
d
d
d
d
d
d
d
d
d
d
d
c
c
c
c
e
k
j
g
"}
(12,1,1) = {"
d
d
d
d
d
d
d
d
d
d
d
d
d
d
c
c
c
c
e
j
j
g
"}
(13,1,1) = {"
d
d
d
d
d
d
d
d
d
d
d
d
d
d
d
d
p
s
q
j
j
h
"}
(14,1,1) = {"
d
d
d
d
d
d
d
d
d
d
d
d
d
d
d
d
r
j
r
j
l
e
"}
(15,1,1) = {"
d
d
d
d
d
d
d
d
d
d
d
d
d
d
d
d
r
j
r
j
j
e
"}
(16,1,1) = {"
d
d
d
d
d
d
d
d
d
d
d
d
d
d
d
d
p
s
s
s
q
e
"}
(17,1,1) = {"
d
d
d
d
d
d
d
d
d
d
d
d
d
d
d
d
c
c
c
c
c
c
"}
(18,1,1) = {"
d
d
d
d
d
d
d
d
d
d
d
d
d
d
c
c
c
c
c
c
c
c
"}
(19,1,1) = {"
d
d
d
d
d
d
d
d
d
d
d
d
d
d
c
c
c
c
c
c
c
c
"}
