//MAP CONVERTED BY dmm2tgm.py THIS HEADER COMMENT PREVENTS RECONVERSION, DO NOT REMOVE
"a" = (
/turf/simulated/floor/planet/jungle/templatethick,
/area/planet/jungle)
"b" = (
/turf/simulated/floor/planet/jungle/rock,
/area/planet/jungle)
"c" = (
/turf/simulated/floor/planet/jungle/clear/underground,
/area/planet/jungle)
"d" = (
/obj/effect/spider,
/turf/simulated/floor/planet/jungle/clear/underground,
/area/planet/jungle)
"e" = (
/obj/random/loot,
/turf/simulated/floor/planet/jungle/clear/underground,
/area/planet/jungle)
"f" = (
/obj/effect/decal/cleanable/dirt,
/turf/simulated/floor/planet/jungle/clear/underground,
/area/planet/jungle)
"g" = (
/obj/random/maintenance/clean,
/turf/simulated/floor/planet/jungle/clear/underground,
/area/planet/jungle)
"h" = (
/obj/random/loot,
/obj/structure/closet/crate,
/turf/simulated/floor/planet/jungle/clear/underground,
/area/planet/jungle)
"i" = (
/obj/effect/spider,
/obj/effect/decal/cleanable/cobweb,
/obj/effect/decal/cleanable/dirt,
/turf/simulated/floor/planet/jungle/clear/underground,
/area/planet/jungle)

(1,1,1) = {"
a
a
a
a
a
a
a
a
a
a
a
a
a
"}
(2,1,1) = {"
a
a
a
a
a
b
b
b
b
b
a
a
a
"}
(3,1,1) = {"
a
a
a
b
b
b
c
c
c
b
b
a
a
"}
(4,1,1) = {"
a
a
b
b
b
d
c
b
f
f
b
b
a
"}
(5,1,1) = {"
a
a
b
b
c
c
c
b
b
f
b
b
a
"}
(6,1,1) = {"
a
b
b
b
c
c
c
c
b
f
f
i
a
"}
(7,1,1) = {"
a
b
b
c
c
c
c
b
b
b
b
b
a
"}
(8,1,1) = {"
b
b
c
c
c
c
b
b
b
b
b
b
a
"}
(9,1,1) = {"
b
b
c
c
c
b
b
b
g
b
b
b
a
"}
(10,1,1) = {"
b
b
c
c
c
c
b
e
c
h
b
b
a
"}
(11,1,1) = {"
b
b
c
c
c
c
c
c
c
c
b
b
a
"}
(12,1,1) = {"
a
b
b
c
c
c
c
c
g
b
b
a
a
"}
(13,1,1) = {"
a
a
b
b
c
c
c
c
b
b
a
a
a
"}
(14,1,1) = {"
a
a
b
b
b
b
b
b
b
a
a
a
a
"}
(15,1,1) = {"
a
a
a
b
b
b
b
b
a
a
a
a
a
"}
