//MAP CONVERTED BY dmm2tgm.py THIS HEADER COMMENT PREVENTS RECONVERSION, DO NOT REMOVE
"a" = (
/obj/structure/disposalpipe/segment,
/turf/simulated/floor/plating,
/area/space)
"b" = (
/turf/simulated/floor/planet/jungle/path,
/area/space)
"c" = (
/turf/simulated/floor/planet/jungle,
/area/space)
"d" = (
/obj/structure/disposalpipe/segment,
/obj/effect/floor_decal/industrial/warning{
	dir = 1
	},
/turf/simulated/floor/plating,
/area/space)
"e" = (
/obj/effect/floor_decal/industrial/warning{
	dir = 5
	},
/turf/simulated/floor/plating,
/area/space)
"f" = (
/obj/structure/disposalpipe/segment,
/obj/effect/floor_decal/industrial/warning,
/turf/simulated/floor/plating,
/area/space)
"g" = (
/obj/effect/floor_decal/industrial/warning{
	dir = 6
	},
/turf/simulated/floor/plating,
/area/space)
"h" = (
/obj/structure/disposalpipe/segment{
	dir = 1;
	icon_state = "pipe-c"
	},
/turf/simulated/floor/plating,
/area/space)
"i" = (
/obj/structure/disposalpipe/segment{
	dir = 4
	},
/turf/simulated/floor/plating,
/area/space)
"j" = (
/obj/structure/disposalpipe/segment{
	dir = 2;
	icon_state = "pipe-c"
	},
/turf/simulated/floor/plating,
/area/space)
"k" = (
/obj/effect/floor_decal/industrial/warning{
	dir = 9
	},
/turf/simulated/floor/plating,
/area/space)
"l" = (
/obj/effect/floor_decal/industrial/warning{
	dir = 10
	},
/turf/simulated/floor/plating,
/area/space)
"m" = (
/obj/structure/disposalpipe/segment{
	dir = 4;
	icon_state = "pipe-c"
	},
/turf/simulated/floor/plating,
/area/space)
"n" = (
/obj/structure/disposalpipe/segment{
	dir = 8;
	icon_state = "pipe-c"
	},
/turf/simulated/floor/plating,
/area/space)
"o" = (
/turf/simulated/floor/planet/jungle/med,
/area/space)

(1,1,1) = {"
a
d
f
a
a
h
c
c
c
c
c
c
b
b
b
b
b
c
c
c
c
b
b
c
c
c
c
c
c
c
c
c
c
c
c
"}
(2,1,1) = {"
b
e
g
c
c
i
c
c
c
c
b
b
b
b
b
b
b
b
b
b
b
b
b
c
c
c
c
c
c
c
c
c
c
b
b
"}
(3,1,1) = {"
b
b
b
c
c
i
c
c
c
b
b
b
b
b
b
b
b
b
b
b
b
b
b
c
c
c
c
c
b
b
c
c
b
b
b
"}
(4,1,1) = {"
c
c
c
c
c
j
a
a
a
a
a
a
a
a
a
a
a
a
a
a
a
h
b
b
b
b
c
c
b
b
b
b
b
b
b
"}
(5,1,1) = {"
c
c
c
c
c
c
c
c
b
b
b
b
b
b
b
b
b
b
b
b
b
i
b
b
b
b
b
b
b
b
b
b
m
a
a
"}
(6,1,1) = {"
c
c
c
c
c
c
c
b
b
b
b
b
b
b
b
b
b
b
b
b
b
j
h
b
b
b
b
b
k
l
b
b
i
b
b
"}
(7,1,1) = {"
c
c
c
c
c
c
b
b
b
b
b
c
c
b
b
b
b
c
b
b
b
b
j
a
a
a
a
a
d
f
a
a
n
b
b
"}
(8,1,1) = {"
c
c
c
c
c
c
b
b
b
b
c
c
c
b
b
b
b
c
c
c
c
b
b
b
b
b
b
b
e
g
b
b
b
b
b
"}
(9,1,1) = {"
c
c
c
c
c
c
b
b
b
b
c
c
c
b
b
b
b
c
c
c
c
b
b
b
b
b
b
b
b
b
b
b
b
b
b
"}
(10,1,1) = {"
c
c
c
c
c
c
b
b
b
b
b
b
b
b
b
b
b
b
b
b
b
b
b
b
b
b
b
b
b
b
b
b
b
c
b
"}
(11,1,1) = {"
c
c
c
c
c
c
b
b
b
b
c
c
c
b
b
b
b
b
b
b
b
b
b
b
b
b
b
c
b
c
c
c
b
c
c
"}
(12,1,1) = {"
c
c
c
c
c
c
b
b
b
b
c
c
c
b
b
b
c
b
b
b
b
b
b
b
c
c
c
c
c
c
c
c
c
c
c
"}
(13,1,1) = {"
c
c
c
c
c
c
b
b
b
b
c
c
c
b
b
b
b
b
b
b
b
b
c
c
c
c
c
c
c
c
c
c
c
c
c
"}
(14,1,1) = {"
c
c
c
c
c
b
b
b
b
b
c
c
b
b
b
b
b
b
b
b
b
b
c
c
c
c
c
c
c
c
c
c
c
c
c
"}
(15,1,1) = {"
c
c
c
c
c
b
b
b
b
b
c
c
b
b
b
b
b
b
c
b
b
b
c
c
c
c
c
c
c
c
c
c
c
c
c
"}
(16,1,1) = {"
c
c
c
c
c
b
b
b
c
c
c
b
b
b
b
b
b
b
c
c
c
c
c
c
c
c
c
c
b
b
c
c
c
c
c
"}
(17,1,1) = {"
c
c
c
c
c
b
b
b
c
c
b
b
b
b
b
b
b
c
c
c
c
b
c
b
b
b
c
c
b
b
b
b
b
c
c
"}
(18,1,1) = {"
c
c
c
c
c
b
b
b
b
c
b
b
b
b
b
b
b
b
b
b
b
b
b
b
b
b
b
b
b
b
b
b
b
b
b
"}
(19,1,1) = {"
c
c
c
c
b
b
b
b
b
b
b
b
b
b
b
b
b
b
b
b
b
b
b
b
b
b
b
b
b
b
b
b
b
b
b
"}
(20,1,1) = {"
c
c
b
b
b
b
b
b
b
b
b
b
b
b
b
b
b
b
b
b
b
b
b
b
b
b
b
b
b
b
b
b
b
b
b
"}
(21,1,1) = {"
c
c
b
b
b
b
b
b
b
b
b
b
b
b
b
b
b
b
b
b
b
b
b
b
b
b
b
b
b
b
b
b
b
b
b
"}
(22,1,1) = {"
c
b
b
b
b
b
b
b
b
b
b
b
b
b
b
b
b
b
b
b
b
b
b
b
b
b
b
b
b
b
b
b
b
b
b
"}
(23,1,1) = {"
c
c
b
b
b
b
b
b
b
b
b
b
b
b
b
b
b
b
b
b
b
b
b
b
b
b
b
b
b
b
b
b
b
b
b
"}
(24,1,1) = {"
c
b
b
b
b
b
b
b
b
b
b
b
b
b
b
b
b
b
b
b
b
b
b
b
b
b
b
b
b
b
b
b
b
b
b
"}
(25,1,1) = {"
c
b
b
b
b
b
b
b
b
b
b
b
b
b
b
b
b
b
b
b
b
b
b
b
b
b
b
b
b
b
b
b
b
b
b
"}
(26,1,1) = {"
c
b
b
b
b
b
b
b
b
b
b
b
b
b
b
b
b
b
b
b
b
b
b
b
b
b
b
b
b
b
b
b
b
b
b
"}
(27,1,1) = {"
b
b
b
b
b
b
b
b
b
b
b
b
b
b
b
b
b
b
b
b
b
b
b
b
b
b
b
b
b
b
b
b
b
b
b
"}
(28,1,1) = {"
b
b
b
b
b
b
b
b
b
b
b
b
b
b
b
b
b
b
b
b
b
b
b
b
b
b
b
b
b
b
b
b
b
b
b
"}
(29,1,1) = {"
b
b
b
b
b
b
b
b
b
b
b
b
b
b
b
b
b
b
b
b
b
b
b
b
c
b
b
b
b
b
b
c
b
b
b
"}
(30,1,1) = {"
b
b
b
b
b
b
b
b
b
b
b
b
b
b
b
b
b
b
b
b
b
b
c
c
c
c
c
c
c
c
c
c
b
b
b
"}
(31,1,1) = {"
b
b
b
b
b
b
b
b
b
b
b
b
b
b
b
b
b
b
b
b
b
b
b
c
c
c
c
c
c
c
c
c
c
c
c
"}
(32,1,1) = {"
b
b
b
b
b
b
b
b
b
b
b
b
b
b
b
b
b
b
b
b
b
b
b
b
b
c
c
c
c
c
c
c
c
c
c
"}
(33,1,1) = {"
b
b
b
b
b
b
b
b
b
b
b
b
b
b
b
b
b
b
b
b
b
b
b
b
b
c
c
c
c
c
c
c
c
c
c
"}
(34,1,1) = {"
b
b
b
b
b
b
b
b
b
b
b
b
b
b
b
b
b
b
b
b
b
b
b
c
c
c
c
c
c
c
c
c
c
c
c
"}
(35,1,1) = {"
b
b
b
b
b
b
b
b
b
b
b
b
b
b
b
b
b
b
b
b
c
c
c
c
c
c
c
c
c
c
c
c
c
c
c
"}
(36,1,1) = {"
b
b
b
b
b
b
b
b
b
b
b
b
b
b
b
b
b
b
b
b
c
c
c
c
c
c
c
c
c
c
c
c
c
c
c
"}
(37,1,1) = {"
b
b
b
b
b
b
b
b
b
b
b
b
b
b
b
c
c
b
b
b
c
c
c
c
c
c
c
c
c
c
c
c
c
c
c
"}
(38,1,1) = {"
b
b
b
c
c
c
b
b
b
c
c
c
c
c
b
c
c
c
c
c
c
c
c
c
c
c
c
c
c
c
c
c
c
c
c
"}
(39,1,1) = {"
c
c
c
c
c
c
c
c
c
c
c
c
c
c
b
c
c
c
c
c
c
c
c
c
c
c
c
c
c
c
c
c
c
o
o
"}
(40,1,1) = {"
c
c
c
c
c
c
c
c
c
c
c
c
c
c
c
c
c
c
c
c
c
c
c
c
c
c
c
c
c
c
c
c
c
o
o
"}
