//MAP CONVERTED BY dmm2tgm.py THIS HEADER COMMENT PREVENTS RECONVERSION, DO NOT REMOVE
"a" = (
/turf/space,
/area/template_noop)
"b" = (
/turf/unsimulated/wall/urist/other/destructable{
	tag = "icon-1,0 (NORTH)";
	icon_state = "1,0";
	dir = 1
	},
/area/template_noop)
"c" = (
/turf/unsimulated/wall/urist/other/destructable{
	tag = "icon-1,0 (SOUTHEAST)";
	icon_state = "1,0";
	dir = 6
	},
/area/template_noop)
"d" = (
/turf/unsimulated/wall/urist/other/destructable{
	tag = "icon-1,0 (SOUTHEAST)";
	icon_state = "1,0";
	dir = 6
	},
/turf/unsimulated/wall/urist/other/destructable{
	tag = "icon-9,15 (SOUTHEAST)";
	icon_state = "9,15";
	dir = 6
	},
/area/template_noop)
"e" = (
/turf/unsimulated/wall/urist/other/destructable{
	tag = "icon-1,0 (EAST)";
	icon_state = "1,0";
	dir = 4
	},
/area/template_noop)
"f" = (
/turf/unsimulated/wall/urist/other/destructable{
	tag = "icon-1,0 (NORTHWEST)";
	icon_state = "1,0";
	dir = 9
	},
/area/template_noop)
"g" = (
/turf/unsimulated/floor/uristturf/other/scom/destructable{
	tag = "icon-5,1";
	icon_state = "5,1"
	},
/turf/unsimulated/wall/urist/other/see/destructable{
	tag = "icon-8,15";
	icon_state = "8,15"
	},
/area/template_noop)
"h" = (
/turf/unsimulated/floor/uristturf/other/scom/destructable{
	tag = "icon-5,1";
	icon_state = "5,1"
	},
/area/template_noop)
"i" = (
/turf/unsimulated/floor/uristturf/other/scom/destructable{
	tag = "icon-9,7";
	icon_state = "9,7"
	},
/area/template_noop)
"j" = (
/turf/unsimulated/floor/uristturf/other/scom/destructable{
	tag = "icon-5,1";
	icon_state = "5,1"
	},
/turf/unsimulated/wall/urist/other/see/destructable{
	tag = "icon-8,15 (NORTH)";
	icon_state = "8,15";
	dir = 1
	},
/area/template_noop)
"k" = (
/turf/unsimulated/wall/urist/other/destructable{
	tag = "icon-1,0 (SOUTHWEST)";
	icon_state = "1,0";
	dir = 10
	},
/area/template_noop)
"l" = (
/turf/unsimulated/floor/uristturf/other/scom/destructable{
	tag = "icon-5,1";
	icon_state = "5,1"
	},
/turf/unsimulated/wall/urist/other/see/destructable{
	tag = "icon-8,14";
	icon_state = "8,14"
	},
/area/template_noop)
"m" = (
/turf/unsimulated/floor/uristturf/other/scom/destructable{
	tag = "icon-5,1";
	icon_state = "5,1"
	},
/turf/unsimulated/wall/urist/other/see/destructable{
	tag = "icon-8,14 (NORTH)";
	icon_state = "8,14";
	dir = 1
	},
/area/template_noop)
"n" = (
/turf/unsimulated/wall/urist/other/destructable{
	tag = "icon-1,0";
	icon_state = "1,0";
	dir = 2
	},
/area/template_noop)
"o" = (
/turf/unsimulated/wall/urist/other/destructable{
	tag = "icon-1,0.1.1.1.1.1.1.1.1 (NORTH)";
	icon_state = "1,0.1.1.1.1.1.1.1.1";
	dir = 1
	},
/area/template_noop)
"p" = (
/turf/unsimulated/wall/urist/other/destructable{
	tag = "icon-1,0 (WEST)";
	icon_state = "1,0";
	dir = 8
	},
/area/template_noop)
"q" = (
/turf/unsimulated/wall/urist/other/destructable{
	tag = "icon-3,15 (NORTHWEST)";
	icon_state = "3,15";
	dir = 9
	},
/area/template_noop)
"r" = (
/turf/unsimulated/wall/urist/other/destructable{
	tag = "icon-3,15";
	icon_state = "3,15";
	dir = 2
	},
/area/template_noop)
"s" = (
/turf/unsimulated/floor/uristturf/other/scom/destructable{
	tag = "icon-3,1";
	icon_state = "3,1"
	},
/area/template_noop)
"t" = (
/turf/unsimulated/wall/urist/other/destructable{
	tag = "icon-3,15 (SOUTHEAST)";
	icon_state = "3,15";
	dir = 6
	},
/area/template_noop)
"u" = (
/turf/unsimulated/wall/urist/other/destructable{
	tag = "icon-3,15 (EAST)";
	icon_state = "3,15";
	dir = 4
	},
/area/template_noop)
"v" = (
/turf/unsimulated/wall/urist/other/see/destructable{
	tag = "icon-0,14";
	icon_state = "0,14"
	},
/area/template_noop)
"w" = (
/turf/unsimulated/floor/uristturf/other/scom/destructable{
	tag = "icon-0,15";
	icon_state = "0,15"
	},
/area/template_noop)
"x" = (
/turf/unsimulated/floor/uristturf/other/scom/destructable{
	tag = "icon-0,15.1";
	icon_state = "0,15.1"
	},
/area/template_noop)
"y" = (
/turf/unsimulated/floor/uristturf/other/scom/destructable{
	tag = "icon-1,15";
	icon_state = "1,15"
	},
/area/template_noop)
"z" = (
/turf/unsimulated/wall/urist/other/see/destructable{
	tag = "icon-1,14";
	icon_state = "1,14"
	},
/area/template_noop)
"A" = (
/turf/unsimulated/wall/urist/other/destructable{
	tag = "icon-3,15 (WEST)";
	icon_state = "3,15";
	dir = 8
	},
/area/template_noop)
"B" = (
/turf/unsimulated/wall/urist/other/destructable{
	tag = "icon-5,14";
	icon_state = "5,14"
	},
/area/template_noop)
"C" = (
/turf/unsimulated/wall/urist/other/destructable{
	tag = "icon-4,14";
	icon_state = "4,14"
	},
/area/template_noop)
"D" = (
/turf/unsimulated/wall/urist/other/see/destructable{
	tag = "icon-2,12";
	icon_state = "2,12"
	},
/area/template_noop)
"E" = (
/turf/unsimulated/wall/urist/other/see/destructable{
	tag = "icon-0,11";
	icon_state = "0,11"
	},
/area/template_noop)
"F" = (
/turf/unsimulated/wall/urist/other/see/destructable{
	tag = "icon-1,10";
	icon_state = "1,10"
	},
/area/template_noop)
"G" = (
/turf/unsimulated/wall/urist/other/see/destructable{
	tag = "icon-0,10";
	icon_state = "0,10"
	},
/area/template_noop)
"H" = (
/turf/unsimulated/wall/urist/other/see/destructable{
	tag = "icon-1,14";
	icon_state = "1,14"
	},
/turf/unsimulated/wall/urist/other/see/destructable{
	tag = "icon-6,14 (EAST)";
	icon_state = "6,14";
	dir = 4
	},
/area/template_noop)
"I" = (
/turf/unsimulated/wall/urist/other/see/destructable{
	tag = "icon-2,12";
	icon_state = "2,12"
	},
/turf/unsimulated/wall/urist/other/see/destructable{
	tag = "icon-6,14 (EAST)";
	icon_state = "6,14";
	dir = 4
	},
/area/template_noop)
"J" = (
/turf/unsimulated/wall/urist/other/destructable{
	tag = "icon-3,0";
	icon_state = "3,0"
	},
/turf/unsimulated/wall/urist/other/see/destructable{
	tag = "icon-6,14 (EAST)";
	icon_state = "6,14";
	dir = 4
	},
/area/template_noop)
"K" = (
/turf/unsimulated/wall/urist/other/see/destructable{
	tag = "icon-0,11";
	icon_state = "0,11"
	},
/turf/unsimulated/wall/urist/other/see/destructable{
	tag = "icon-6,14 (EAST)";
	icon_state = "6,14";
	dir = 4
	},
/area/template_noop)
"L" = (
/turf/unsimulated/wall/urist/other/see/destructable{
	tag = "icon-0,14";
	icon_state = "0,14"
	},
/turf/unsimulated/wall/urist/other/see/destructable{
	tag = "icon-6,14 (EAST)";
	icon_state = "6,14";
	dir = 4
	},
/area/template_noop)
"M" = (
/turf/unsimulated/wall/urist/other/destructable{
	tag = "icon-3,0";
	icon_state = "3,0"
	},
/area/template_noop)
"N" = (
/turf/unsimulated/wall/urist/other/see/destructable{
	tag = "icon-3,0";
	icon_state = "3,0"
	},
/area/template_noop)
"O" = (
/turf/unsimulated/wall/urist/other/destructable{
	tag = "icon-3,15 (NORTHEAST)";
	icon_state = "3,15";
	dir = 5
	},
/area/template_noop)
"P" = (
/turf/unsimulated/wall/urist/other/destructable{
	tag = "icon-123456 (WEST)";
	icon_state = "123456";
	dir = 8
	},
/area/template_noop)
"Q" = (
/turf/unsimulated/wall/urist/other/destructable{
	tag = "icon-3,15 (NORTH)";
	icon_state = "3,15";
	dir = 1
	},
/area/template_noop)
"R" = (
/turf/unsimulated/wall/urist/other/destructable{
	tag = "icon-3,15 (SOUTHWEST)";
	icon_state = "3,15";
	dir = 10
	},
/area/template_noop)
"S" = (
/turf/unsimulated/floor/uristturf/other/scom/destructable{
	tag = "icon-2,14";
	icon_state = "2,14"
	},
/area/template_noop)
"T" = (
/turf/unsimulated/floor/uristturf/other/scom/destructable{
	tag = "icon-2,14 (SOUTHEAST)";
	icon_state = "2,14";
	dir = 6
	},
/area/template_noop)
"U" = (
/turf/unsimulated/floor/uristturf/other/scom/destructable{
	tag = "icon-2,14 (NORTH)";
	icon_state = "2,14";
	dir = 1
	},
/area/template_noop)

(1,1,1) = {"
a
a
a
a
a
a
a
a
a
q
u
u
u
u
u
u
u
u
u
u
u
u
u
u
u
u
u
u
u
u
u
u
u
u
u
O
a
a
"}
(2,1,1) = {"
a
a
a
a
a
a
a
a
a
r
v
v
v
v
v
v
v
v
v
v
v
v
v
v
v
v
v
v
v
v
v
v
v
v
v
P
u
u
"}
(3,1,1) = {"
a
a
a
a
a
a
a
a
a
r
w
w
w
w
w
w
w
w
w
w
w
w
w
w
w
w
w
w
w
w
w
w
w
w
w
w
S
S
"}
(4,1,1) = {"
a
a
a
a
a
a
a
a
a
r
x
x
x
x
x
x
x
x
x
x
x
x
x
x
x
x
x
x
x
x
x
x
x
x
x
x
T
T
"}
(5,1,1) = {"
a
a
a
a
a
a
a
a
a
r
y
y
y
y
y
y
y
y
y
y
y
y
y
y
y
y
y
y
y
y
x
x
y
y
y
y
U
U
"}
(6,1,1) = {"
b
f
f
f
f
n
a
a
a
r
z
z
z
z
z
z
z
z
z
z
z
z
z
z
z
z
z
z
z
z
x
x
H
z
z
P
A
A
"}
(7,1,1) = {"
c
g
l
g
l
o
f
f
f
r
u
u
u
B
D
D
F
D
D
D
F
D
D
D
F
D
D
D
F
D
x
x
I
D
D
Q
a
a
"}
(8,1,1) = {"
c
h
h
h
h
h
h
h
h
s
h
h
h
h
i
i
i
i
i
i
i
i
i
i
i
i
i
i
i
s
x
x
J
M
M
Q
a
a
"}
(9,1,1) = {"
d
i
i
i
i
i
i
i
i
r
A
A
A
C
E
E
E
E
E
E
E
E
E
E
E
E
E
E
E
E
x
x
K
E
E
Q
a
a
"}
(10,1,1) = {"
d
i
i
i
i
i
i
i
i
r
u
u
u
B
D
D
D
D
D
D
D
D
D
D
D
D
D
D
D
D
x
x
I
D
D
Q
a
a
"}
(11,1,1) = {"
c
h
h
h
h
h
h
h
h
s
h
h
h
h
i
i
i
i
i
i
i
i
i
i
i
i
i
i
i
s
x
x
J
N
N
Q
a
a
"}
(12,1,1) = {"
c
j
m
j
m
o
k
k
k
r
A
A
A
C
E
E
E
E
E
G
E
E
G
E
G
E
E
E
G
E
x
x
K
E
E
Q
a
a
"}
(13,1,1) = {"
e
k
k
k
k
p
a
a
a
r
v
v
v
v
v
v
v
v
v
v
v
v
v
v
v
v
v
v
v
v
x
x
L
v
v
P
u
u
"}
(14,1,1) = {"
a
a
a
a
a
a
a
a
a
r
w
w
w
w
w
w
w
w
w
w
w
w
w
w
w
w
w
w
w
w
x
x
w
w
w
w
S
S
"}
(15,1,1) = {"
a
a
a
a
a
a
a
a
a
r
x
x
x
x
x
x
x
x
x
x
x
x
x
x
x
x
x
x
x
x
x
x
x
x
x
x
T
T
"}
(16,1,1) = {"
a
a
a
a
a
a
a
a
a
r
y
y
y
y
y
y
y
y
y
y
y
y
y
y
y
y
y
y
y
y
y
y
y
y
y
y
U
U
"}
(17,1,1) = {"
a
a
a
a
a
a
a
a
a
r
z
z
z
z
z
z
z
z
z
z
z
z
z
z
z
z
z
z
z
z
z
z
z
z
z
P
A
A
"}
(18,1,1) = {"
a
a
a
a
a
a
a
a
a
t
A
A
A
A
A
A
A
A
A
A
A
A
A
A
A
A
A
A
A
A
A
A
A
A
A
R
a
a
"}
