//MAP CONVERTED BY dmm2tgm.py THIS HEADER COMMENT PREVENTS RECONVERSION, DO NOT REMOVE
"a" = (
/turf/space,
/area/space)
"b" = (
/turf/simulated/mineral,
/area/space)
"c" = (
/turf/simulated/mineral/random,
/area/space)
"d" = (
/turf/simulated/mineral/random/high_chance,
/area/space)

(1,1,1) = {"
a
a
a
a
a
a
a
a
a
a
a
a
b
a
a
a
"}
(2,1,1) = {"
a
a
a
a
a
a
a
a
a
a
b
b
b
b
a
a
"}
(3,1,1) = {"
a
a
a
c
a
a
a
a
a
b
b
b
c
b
b
a
"}
(4,1,1) = {"
a
a
a
c
c
a
a
a
a
b
b
c
c
c
b
b
"}
(5,1,1) = {"
a
a
b
b
c
c
a
a
b
b
c
c
c
c
b
b
"}
(6,1,1) = {"
a
b
b
b
c
c
a
a
b
b
d
c
c
c
b
a
"}
(7,1,1) = {"
a
a
b
b
b
a
a
a
a
b
b
b
b
b
b
b
"}
(8,1,1) = {"
a
a
b
a
a
a
a
a
a
b
a
b
b
a
a
a
"}
(9,1,1) = {"
a
a
a
a
a
a
b
a
a
a
a
a
a
a
a
a
"}
(10,1,1) = {"
a
a
a
a
a
a
c
c
c
a
a
a
a
a
a
a
"}
(11,1,1) = {"
a
a
a
a
a
b
c
c
c
c
c
a
a
a
a
a
"}
(12,1,1) = {"
a
a
a
a
a
b
c
c
c
c
b
a
a
a
a
a
"}
(13,1,1) = {"
a
a
a
a
a
b
a
c
b
b
a
a
a
a
a
a
"}
(14,1,1) = {"
a
a
a
a
a
a
a
a
a
a
a
a
a
a
a
a
"}
(15,1,1) = {"
a
a
a
a
a
a
a
a
a
a
a
a
a
a
a
a
"}
(16,1,1) = {"
a
a
a
a
a
a
a
a
a
a
a
a
a
a
a
a
"}
